CD Block_Code,Town/Village_Code,Name,Main Working Population Person,Main Working Population Male,Main Working Population Female,Main Cultivator Population Person,Main Cultivator Population Male,Main Cultivator Population Female,Main Agricultural Labourers Population Person,Main Agricultural Labourers Population Male,Main Agricultural Labourers Population Female,Main Household Industries Population Person,Main Household Industries Population Male,Main Household Industries Population Female,Main Other Workers Population Person,Main Other Workers Population Male,Main Other Workers Population Female
0016,042138,Ukhimath,18899,9229,9670,14208,5367,8841,213,116,97,195,132,63,4283,3614,669
0016,042054,Garuriya,0,0,0,0,0,0,0,0,0,0,0,0,0,0,0
0016,042055,Ghinurpani,0,0,0,0,0,0,0,0,0,0,0,0,0,0,0
0016,042056,Rambara,0,0,0,0,0,0,0,0,0,0,0,0,0,0,0
0016,042057,Sarana Losan,0,0,0,0,0,0,0,0,0,0,0,0,0,0,0
0016,042058,Gaurikund,147,94,53,99,48,51,2,1,1,0,0,0,46,45,1
0016,042059,Mundkatiya,22,13,9,21,12,9,0,0,0,0,0,0,1,1,0
0016,042060,Tausi,84,39,45,81,38,43,0,0,0,0,0,0,3,1,2
0016,042061,Trijuginarayan,525,263,262,445,196,249,2,0,2,1,1,0,77,66,11
0016,042062,Kongarh,86,46,40,60,23,37,0,0,0,0,0,0,26,23,3
0016,042063,Nyalsu,315,173,142,233,106,127,2,0,2,18,16,2,62,51,11
0016,042064,Sersi,116,52,64,102,42,60,1,0,1,0,0,0,13,10,3
0016,042065,Gair,37,18,19,36,17,19,0,0,0,0,0,0,1,1,0
0016,042066,Barasu,433,214,219,387,171,216,0,0,0,0,0,0,46,43,3
0016,042067,Tarsali,44,22,22,30,12,18,6,3,3,0,0,0,8,7,1
0016,042068,Jamu,319,141,178,309,132,177,0,0,0,0,0,0,10,9,1
0016,042069,Phata,51,39,12,4,2,2,0,0,0,0,0,0,47,37,10
0016,042070,Khat,131,61,70,110,44,66,5,2,3,0,0,0,16,15,1
0016,042071,Dhani,126,60,66,120,54,66,0,0,0,0,0,0,6,6,0
0016,042072,Khariya,270,117,153,243,93,150,1,0,1,0,0,0,26,24,2
0016,042073,Dharwal Gaon,10,8,2,0,0,0,0,0,0,0,0,0,10,8,2
0016,042074,Rabigram,53,31,22,21,1,20,0,0,0,0,0,0,32,30,2
0016,042075,Maikhanda,394,182,212,390,179,211,2,1,1,1,1,0,1,1,0
0016,042076,Byung,95,52,43,54,12,42,0,0,0,0,0,0,41,40,1
0016,042077,Rail,32,15,17,32,15,17,0,0,0,0,0,0,0,0,0
0016,042078,Lolchhara,0,0,0,0,0,0,0,0,0,0,0,0,0,0,0
0016,042079,Jalmalla,274,133,141,186,53,133,1,0,1,4,3,1,83,77,6
0016,042080,Jaltalla,176,89,87,99,18,81,0,0,0,0,0,0,77,71,6
0016,042081,Chaumasi,1,1,0,0,0,0,0,0,0,0,0,0,1,1,0
0016,042082,Chilond,177,82,95,121,28,93,0,0,0,0,0,0,56,54,2
0016,042083,Syansu,91,35,56,87,32,55,0,0,0,0,0,0,4,3,1
0016,042084,Khunnu,14,9,5,5,1,4,2,2,0,2,2,0,5,4,1
0016,042085,Kotma,298,155,143,277,135,142,0,0,0,3,2,1,18,18,0
0016,042086,Kabiltha,157,95,62,86,29,57,0,0,0,0,0,0,71,66,5
0016,042087,Kalimath,262,124,138,251,116,135,0,0,0,0,0,0,11,8,3
0016,042088,Byunkhi,179,82,97,165,72,93,0,0,0,0,0,0,14,10,4
0016,042089,Kunjethi,187,85,102,152,54,98,0,0,0,0,0,0,35,31,4
0016,042090,Thali Laga Kali Math,0,0,0,0,0,0,0,0,0,0,0,0,0,0,0
0016,042091,Jurani,42,22,20,26,8,18,1,0,1,1,1,0,14,13,1
0016,042092,Gwita,13,9,4,7,3,4,0,0,0,0,0,0,6,6,0
0016,042093,Korkhimalli,24,12,12,21,9,12,0,0,0,0,0,0,3,3,0
0016,042094,Korkhitalli,36,15,21,29,11,18,0,0,0,0,0,0,7,4,3
0016,042095,Semkwerala,16,6,10,13,3,10,0,0,0,0,0,0,3,3,0
0016,042096,Tyuri,241,106,135,165,41,124,0,0,0,0,0,0,76,65,11
0016,042097,Khumera,434,186,248,332,100,232,1,0,1,1,1,0,100,85,15
0016,042098,Barasu,90,74,16,6,3,3,0,0,0,0,0,0,84,71,13
0016,042099,Bhetsem,247,144,103,197,103,94,2,1,1,17,11,6,31,29,2
0016,042100,Hyuna,26,25,1,2,2,0,1,1,0,0,0,0,23,22,1
0016,042101,Nala,397,195,202,188,21,167,2,0,2,2,1,1,205,173,32
0016,042102,Kothera,74,31,43,55,19,36,0,0,0,2,1,1,17,11,6
0016,042103,Deosal,94,41,53,71,21,50,0,0,0,2,2,0,21,18,3
0016,042104,Rudrpur,231,93,138,209,77,132,1,0,1,0,0,0,21,16,5
0016,042105,Gadi,18,18,0,2,2,0,0,0,0,1,1,0,15,15,0
0016,042106,Guptkashi,392,258,134,105,30,75,1,0,1,2,2,0,284,226,58
0016,042107,Dewar,438,188,250,409,164,245,0,0,0,0,0,0,29,24,5
0016,042108,Sankari,417,212,205,222,74,148,18,11,7,3,1,2,174,126,48
0016,042109,Bhainsari,39,34,5,10,9,1,0,0,0,0,0,0,29,25,4
0016,042110,Asama,3,2,1,0,0,0,0,0,0,0,0,0,3,2,1
0016,042111,Semtalli,94,48,46,45,9,36,0,0,0,1,1,0,48,38,10
0016,042112,Thaglasi,13,9,4,4,1,3,0,0,0,0,0,0,9,8,1
0016,042113,Dharsemi,20,17,3,2,0,2,0,0,0,0,0,0,18,17,1
0016,042114,Rauchak Chauki,0,0,0,0,0,0,0,0,0,0,0,0,0,0,0
0016,042115,Paundar,7,6,1,7,6,1,0,0,0,0,0,0,0,0,0
0016,042116,Uniyara,284,122,162,263,108,155,0,0,0,2,1,1,19,13,6
0016,042117,Ransi Tarsali,161,80,81,150,70,80,0,0,0,0,0,0,11,10,1
0016,042118,Gaundar,132,60,72,120,51,69,0,0,0,0,0,0,12,9,3
0016,042119,Raulek,570,256,314,518,212,306,12,7,5,2,2,0,38,35,3
0016,042120,Kheti Nadla,28,21,7,27,20,7,0,0,0,0,0,0,1,1,0
0016,042121,Jaggi Bagwan,314,142,172,309,138,171,0,0,0,0,0,0,5,4,1
0016,042122,Bedulaban,100,86,14,94,82,12,0,0,0,0,0,0,6,4,2
0016,042123,Kunjalpur,25,11,14,21,8,13,0,0,0,0,0,0,4,3,1
0016,042124,Mansuna,342,173,169,262,110,152,2,2,0,3,3,0,75,58,17
0016,042125,Jugasuchak Biroli,0,0,0,0,0,0,0,0,0,0,0,0,0,0,0
0016,042126,Biroli,1,1,0,1,1,0,0,0,0,0,0,0,0,0,0
0016,042127,Burua,148,71,77,126,54,72,0,0,0,2,2,0,20,15,5
0016,042128,Madali,3,1,2,3,1,2,0,0,0,0,0,0,0,0,0
0016,042129,Gadagu,118,20,98,103,10,93,2,1,1,0,0,0,13,9,4
0016,042130,Gair,198,86,112,173,63,110,1,0,1,0,0,0,24,23,1
0016,042131,Basti,30,15,15,28,13,15,0,0,0,1,1,0,1,1,0
0016,042132,Giriya,243,89,154,197,51,146,0,0,0,4,4,0,42,34,8
0016,042133,Fanphaj,153,98,55,105,57,48,0,0,0,1,1,0,47,40,7
0016,042134,Saruna,46,18,28,32,7,25,0,0,0,0,0,0,14,11,3
0016,042135,Pali,55,47,8,41,34,7,1,1,0,0,0,0,13,12,1
0016,042136,Chunni,132,62,70,78,12,66,0,0,0,0,0,0,54,50,4
0016,042137,Mangoli,95,41,54,62,11,51,0,0,0,0,0,0,33,30,3
0016,042138,Ukhimath,684,393,291,271,68,203,5,5,0,19,15,4,389,305,84
0016,042139,Dilmi,34,14,20,21,1,20,0,0,0,0,0,0,13,13,0
0016,042140,Sari,133,22,111,102,1,101,0,0,0,0,0,0,31,21,10
0016,042141,Daira,164,83,81,116,39,77,1,1,0,0,0,0,47,43,4
0016,042142,Barangali,85,37,48,52,5,47,0,0,0,0,0,0,33,32,1
0016,042143,Karokhi,322,133,189,291,104,187,1,0,1,0,0,0,30,29,1
0016,042144,Kantha,17,6,11,14,3,11,0,0,0,1,1,0,2,2,0
0016,042145,Painj,124,41,83,113,34,79,2,1,1,0,0,0,9,6,3
0016,042146,Bhatwari,226,117,109,140,58,82,0,0,0,4,1,3,82,58,24
0016,042147,Sansari,99,71,28,38,10,28,0,0,0,2,2,0,59,59,0
0016,042148,Kimana,197,92,105,168,63,105,0,0,0,0,0,0,29,29,0
0016,042149,Raudu,28,11,17,20,3,17,0,0,0,0,0,0,8,8,0
0016,042150,Gundagwar,10,4,6,9,3,6,0,0,0,0,0,0,1,1,0
0016,042151,Kanda,73,21,52,67,18,49,1,0,1,0,0,0,5,3,2
0016,042152,Huddu,75,71,4,33,33,0,0,0,0,0,0,0,42,38,4
0016,042153,Ushara,193,93,100,169,74,95,0,0,0,1,1,0,23,18,5
0016,042154,Bhankund,8,5,3,8,5,3,0,0,0,0,0,0,0,0,0
0016,042155,Pothiwasa,0,0,0,0,0,0,0,0,0,0,0,0,0,0,0
0016,042156,Tungnath,0,0,0,0,0,0,0,0,0,0,0,0,0,0,0
0016,042157,Chopta,0,0,0,0,0,0,0,0,0,0,0,0,0,0,0
0016,042158,Baniyakund,0,0,0,0,0,0,0,0,0,0,0,0,0,0,0
0016,042159,Dogalbhita,0,0,0,0,0,0,0,0,0,0,0,0,0,0,0
0016,042160,Gujargwar,0,0,0,0,0,0,0,0,0,0,0,0,0,0,0
0016,042161,Dilangwar,4,0,4,3,0,3,0,0,0,0,0,0,1,0,1
0016,042162,Makku,295,139,156,231,85,146,0,0,0,5,5,0,59,49,10
0016,042163,Silgoth,5,2,3,3,1,2,0,0,0,0,0,0,2,1,1
0016,042164,Semar,1,1,0,0,0,0,0,0,0,0,0,0,1,1,0
0016,042165,Dungar semala,238,107,131,213,85,128,1,1,0,0,0,0,24,21,3
0016,042166,Pathali,40,33,7,0,0,0,0,0,0,0,0,0,40,33,7
0016,042167,Kundaliya,10,8,2,0,0,0,0,0,0,0,0,0,10,8,2
0016,042168,Garwali,26,19,7,3,0,3,0,0,0,0,0,0,23,19,4
0016,042169,Chinagwar,0,0,0,0,0,0,0,0,0,0,0,0,0,0,0
0016,042170,Bhingi,126,57,69,87,29,58,0,0,0,0,0,0,39,28,11
0016,042171,Lakshman Gwar,15,7,8,11,4,7,0,0,0,0,0,0,4,3,1
0016,042172,Tankila,49,19,30,37,10,27,2,1,1,0,0,0,10,8,2
0016,042173,Parkandi,871,372,499,725,245,480,15,11,4,9,8,1,122,108,14
0016,042174,Giwari Gaon,105,85,20,19,0,19,0,0,0,0,0,0,86,85,1
0016,042175,Kyark,8,7,1,0,0,0,0,0,0,0,0,0,8,7,1
0016,042176,Kuher,3,1,2,0,0,0,0,0,0,0,0,0,3,1,2
0016,042177,Pailing,48,28,20,36,20,16,0,0,0,0,0,0,12,8,4
0016,042178,Uthind,23,18,5,4,2,2,0,0,0,1,1,0,18,15,3
0016,042179,Kail,4,3,1,1,1,0,0,0,0,2,1,1,1,1,0
0016,042180,Jagpura,11,8,3,0,0,0,0,0,0,0,0,0,11,8,3
0016,042181,Paw,8,6,2,0,0,0,0,0,0,0,0,0,8,6,2
0016,042182,Kirmoriya,2,1,1,2,1,1,0,0,0,0,0,0,0,0,0
0016,042183,Jamalok ,30,12,18,30,12,18,0,0,0,0,0,0,0,0,0
0016,042184,Khal,4,2,2,0,0,0,4,2,2,0,0,0,0,0,0
0016,042185,Lwara,435,182,253,274,102,172,79,35,44,14,11,3,68,34,34
0016,042186,Dewagana,96,54,42,8,7,1,2,0,2,55,19,36,31,28,3
0016,042187,Salya,209,99,110,167,64,103,1,1,0,1,1,0,40,33,7
0016,042188,Khera,106,46,60,70,11,59,23,22,1,0,0,0,13,13,0
0016,042189,Tulanga,457,197,260,397,145,252,5,2,3,0,0,0,55,50,5
0016,042190,Chaundi,35,18,17,32,15,17,1,1,0,1,1,0,1,1,0
0016,042191,Lwani,67,61,6,57,51,6,0,0,0,0,0,0,10,10,0
0016,042192,Andrawahi,77,31,46,50,11,39,0,0,0,0,0,0,27,20,7
0016,042193,Singoli,79,40,39,51,14,37,0,0,0,0,0,0,28,26,2
0016,042194,Namoli,16,6,10,14,4,10,0,0,0,0,0,0,2,2,0
0016,042195,Akardhar,8,4,4,6,2,4,0,0,0,0,0,0,2,2,0
0016,042196,Lamgondi,565,273,292,452,170,282,0,0,0,4,4,0,109,99,10
0016,042197,Phali Phasalat,138,64,74,82,10,72,0,0,0,0,0,0,56,54,2
0016,042198,Dewali Bhanigram,523,224,299,465,180,285,1,0,1,0,0,0,57,44,13
0017,000000,Augustmuni,30828,14494,16334,21346,7270,14076,934,384,550,906,564,342,7642,6276,1366
0017,000000,Augustmuni,30828,14494,16334,21346,7270,14076,934,384,550,906,564,342,7642,6276,1366
0017,000000,Augustmuni,0,0,0,0,0,0,0,0,0,0,0,0,0,0,0
0017,042199,Patiyaun,5,5,0,1,1,0,0,0,0,0,0,0,4,4,0
0017,042200,Bareth,141,49,92,103,14,89,2,0,2,0,0,0,36,35,1
0017,042201,Jaula,176,66,110,171,64,107,3,1,2,1,0,1,1,1,0
0017,042202,Tal Jamana,277,136,141,41,12,29,125,33,92,64,54,10,47,37,10
0017,042203,Paula Kundalia,50,13,37,46,9,37,0,0,0,1,1,0,3,3,0
0017,042204,Himola,8,2,6,6,0,6,0,0,0,0,0,0,2,2,0
0017,042205,Brambari,209,84,125,197,73,124,0,0,0,6,6,0,6,5,1
0017,042206,Temariapalla,4,4,0,0,0,0,0,0,0,1,1,0,3,3,0
0017,042207,Tat Laga Phegu,0,0,0,0,0,0,0,0,0,0,0,0,0,0,0
0017,042208,Phegu,473,205,268,439,180,259,6,2,4,6,4,2,22,19,3
0017,042209,Nag Jagayi,312,113,199,233,47,186,1,0,1,1,1,0,77,65,12
0017,042210,Tinsoli,90,48,42,36,12,24,9,2,7,22,16,6,23,18,5
0017,042211,Bhatwari,67,32,35,47,22,25,12,4,8,2,1,1,6,5,1
0017,042212,Dungar,94,43,51,71,22,49,0,0,0,0,0,0,23,21,2
0017,042213,Ghatbagar,0,0,0,0,0,0,0,0,0,0,0,0,0,0,0
0017,042214,Basti,371,176,195,198,28,170,7,2,5,29,14,15,137,132,5
0017,042215,Damar,297,144,153,243,98,145,0,0,0,21,18,3,33,28,5
0017,042216,Temariyawala,1,1,0,0,0,0,0,0,0,1,1,0,0,0,0
0017,042217,Jalai Sursal,485,180,305,400,106,294,1,0,1,3,2,1,81,72,9
0017,042218,Auring,3,3,0,0,0,0,0,0,0,0,0,0,3,3,0
0017,042219,Bhiri,176,161,15,10,8,2,13,12,1,4,4,0,149,137,12
0017,042220,Nagarsal,0,0,0,0,0,0,0,0,0,0,0,0,0,0,0
0017,042221,Birondewal,271,121,150,253,107,146,1,0,1,1,1,0,16,13,3
0017,042222,Gair,66,23,43,51,10,41,0,0,0,0,0,0,15,13,2
0017,042223,Kandara,430,186,244,246,85,161,34,18,16,72,30,42,78,53,25
0017,042224,Raigu,16,6,10,10,3,7,0,0,0,2,2,0,4,1,3
0017,042225,Kanyas,43,9,34,42,8,34,0,0,0,0,0,0,1,1,0
0017,042226,Daula,115,40,75,98,27,71,0,0,0,2,2,0,15,11,4
0017,042227,Jaikhanda,70,29,41,63,24,39,0,0,0,0,0,0,7,5,2
0017,042228,Akhauri,204,85,119,143,32,111,1,1,0,4,3,1,56,49,7
0017,042229,Sena garhsari,62,46,16,58,43,15,0,0,0,0,0,0,4,3,1
0017,042230,Balsundi,64,34,30,60,30,30,0,0,0,0,0,0,4,4,0
0017,042231,Karnsili,140,50,90,117,31,86,0,0,0,0,0,0,23,19,4
0017,042232,Kyunja,483,199,284,449,177,272,3,3,0,7,7,0,24,12,12
0017,042233,Ajaipur,32,13,19,32,13,19,0,0,0,0,0,0,0,0,0
0017,042234,Asondadian,96,42,54,96,42,54,0,0,0,0,0,0,0,0,0
0017,042235,Sera,53,26,27,53,26,27,0,0,0,0,0,0,0,0,0
0017,042236,Kunjethi,18,7,11,13,2,11,0,0,0,0,0,0,5,5,0
0017,042237,Jaykandi,148,56,92,137,47,90,0,0,0,0,0,0,11,9,2
0017,042238,Mundasu,23,9,14,22,9,13,0,0,0,0,0,0,1,0,1
0017,042239,Sena Chak Chhara,0,0,0,0,0,0,0,0,0,0,0,0,0,0,0
0017,042240,Bhanaj Gwar,163,159,4,133,133,0,0,0,0,0,0,0,30,26,4
0017,042241,Machkandi,69,46,23,48,35,13,6,3,3,6,3,3,9,5,4
0017,042242,Jawari,22,10,12,17,6,11,0,0,0,0,0,0,5,4,1
0017,042243,Kandi,370,187,183,363,183,180,0,0,0,0,0,0,7,4,3
0017,042244,Tewri,154,62,92,143,52,91,0,0,0,0,0,0,11,10,1
0017,042245,Kalai,52,18,34,49,16,33,1,0,1,1,1,0,1,1,0
0017,042246,Kontha,166,51,115,166,51,115,0,0,0,0,0,0,0,0,0
0017,042247,Kera Malla,98,93,5,79,77,2,0,0,0,0,0,0,19,16,3
0017,042248,Kera Talla,1,1,0,0,0,0,1,1,0,0,0,0,0,0,0
0017,042249,Dungri,136,50,86,3,1,2,122,40,82,0,0,0,11,9,2
0017,042250,Moli,56,20,36,56,20,36,0,0,0,0,0,0,0,0,0
0017,042251,Baraw Talla,10,9,1,0,0,0,0,0,0,0,0,0,10,9,1
0017,042252,Baraw Bichalla,8,7,1,0,0,0,0,0,0,0,0,0,8,7,1
0017,042253,Baraw Malla,100,78,22,92,72,20,1,0,1,0,0,0,7,6,1
0017,042254,Kinjani,421,162,259,365,117,248,0,0,0,0,0,0,56,45,11
0017,042255,Kyark Barsuri,413,161,252,357,115,242,6,5,1,5,3,2,45,38,7
0017,042256,Naini Pondar,147,65,82,112,35,77,1,1,0,2,1,1,32,28,4
0017,042257,Sangur,63,23,40,56,18,38,0,0,0,1,1,0,6,4,2
0017,042258,Pali,173,74,99,167,71,96,1,0,1,0,0,0,5,3,2
0017,042259,Ryasun,87,35,52,78,30,48,0,0,0,1,1,0,8,4,4
0017,042260,Dalsingi,340,147,193,295,110,185,2,0,2,0,0,0,43,37,6
0017,042261,Korl(Kaushalpur),14,10,4,5,3,2,0,0,0,1,1,0,8,6,2
0017,042262,Kund,109,57,52,71,22,49,0,0,0,0,0,0,38,35,3
0017,042263,Chandrapuri,14,13,1,0,0,0,0,0,0,0,0,0,14,13,1
0017,042264,Gawni Chak Bachwar,0,0,0,0,0,0,0,0,0,0,0,0,0,0,0
0017,042265,Matkhani,23,6,17,22,5,17,0,0,0,0,0,0,1,1,0
0017,042266,Duwarkhu,22,10,12,15,5,10,0,0,0,0,0,0,7,5,2
0017,042267,Bhatwari Sunar,172,77,95,112,28,84,2,1,1,2,2,0,56,46,10
0017,042268,Naili,132,60,72,75,17,58,7,2,5,4,4,0,46,37,9
0017,042269,Guna Kyark,30,15,15,19,5,14,0,0,0,0,0,0,11,10,1
0017,042270,Phalai,342,167,175,236,70,166,0,0,0,1,1,0,105,96,9
0017,042271,Hat,191,70,121,179,63,116,0,0,0,0,0,0,12,7,5
0017,042272,Beru Bagar,0,0,0,0,0,0,0,0,0,0,0,0,0,0,0
0017,042273,Koti,66,24,42,50,9,41,0,0,0,1,1,0,15,14,1
0017,042274,Dangi,452,182,270,426,159,267,0,0,0,0,0,0,26,23,3
0017,042275,Sogna,117,48,69,103,36,67,0,0,0,0,0,0,14,12,2
0017,042276,Sindhata,211,98,113,191,82,109,6,3,3,2,2,0,12,11,1
0017,042277,Dadoli,336,88,248,291,45,246,0,0,0,0,0,0,45,43,2
0017,042278,Silla Baman Gaon,461,147,314,376,72,304,3,1,2,13,13,0,69,61,8
0017,042279,Gadanu,110,51,59,78,20,58,0,0,0,5,4,1,27,27,0
0017,042280,Chamarara,23,10,13,15,2,13,0,0,0,0,0,0,8,8,0
0017,042281,Mahardhar,57,31,26,42,18,24,0,0,0,0,0,0,15,13,2
0017,042282,Ginwala,157,57,100,117,21,96,1,0,1,2,2,0,37,34,3
0017,042283,Gabni Gaon,190,91,99,112,27,85,10,8,2,6,6,0,62,50,12
0017,042284,Butola Gaon,124,54,70,84,20,64,0,0,0,0,0,0,40,34,6
0017,042285,Kakola,55,27,28,39,11,28,0,0,0,0,0,0,16,16,0
0017,042286,Gugali,61,22,39,55,18,37,1,0,1,0,0,0,5,4,1
0017,042287,Mahar Gaon,39,20,19,39,20,19,0,0,0,0,0,0,0,0,0
0017,042288,Shishi,96,39,57,95,39,56,1,0,1,0,0,0,0,0,0
0017,042289,Tondala,18,17,1,1,1,0,0,0,0,1,1,0,16,15,1
0017,042290,Kala Kot,36,29,7,18,12,6,2,1,1,9,9,0,7,7,0
0017,042291,Dhar,92,34,58,85,28,57,2,1,1,2,2,0,3,3,0
0017,042292,Pillu ,110,74,36,89,56,33,0,0,0,0,0,0,21,18,3
0017,042293,Jahangi,99,30,69,78,12,66,0,0,0,0,0,0,21,18,3
0017,042294,Toliyon,74,29,45,59,16,43,0,0,0,0,0,0,15,13,2
0017,042295,Tilsari,66,26,40,43,6,37,0,0,0,0,0,0,23,20,3
0017,042296,Onga Laga Kamsal,30,12,18,24,6,18,0,0,0,0,0,0,6,6,0
0017,042297,Kamsal,236,104,132,157,28,129,0,0,0,0,0,0,79,76,3
0017,042298,Jagoth,126,118,8,83,79,4,0,0,0,0,0,0,43,39,4
0017,042299,Banjgadu,51,13,38,45,7,38,0,0,0,1,1,0,5,5,0
0017,042320,Narkota,156,65,91,115,28,87,0,0,0,0,0,0,41,37,4
0017,042321,Naugaon Laga Bolani,20,10,10,12,2,10,0,0,0,0,0,0,8,8,0
0017,042322,Khankra,42,19,23,20,0,20,0,0,0,0,0,0,22,19,3
0017,042323,Dejimanda,68,36,32,39,10,29,0,0,0,0,0,0,29,26,3
0017,042324,Chantikhal,13,7,6,11,5,6,0,0,0,0,0,0,2,2,0
0017,042325,Sirobagarh,3,1,2,2,0,2,0,0,0,0,0,0,1,1,0
0017,042326,Sunau,19,16,3,0,0,0,0,0,0,0,0,0,19,16,3
0017,042327,Rampur,31,25,6,8,8,0,0,0,0,4,4,0,19,13,6
0017,042328,Fateh Pur,79,27,52,57,7,50,0,0,0,1,1,0,21,19,2
0017,042329,Badion,6,6,0,5,5,0,0,0,0,0,0,0,1,1,0
0017,042330,Kleth,65,28,37,56,21,35,1,0,1,1,1,0,7,6,1
0017,042331,Mar Gaon,3,3,0,0,0,0,0,0,0,0,0,0,3,3,0
0017,042332,Nishni,7,4,3,0,0,0,0,0,0,0,0,0,7,4,3
0017,042333,Chamiun,1,1,0,1,1,0,0,0,0,0,0,0,0,0,0
0017,042334,Pandhara,31,13,18,24,8,16,0,0,0,0,0,0,7,5,2
0017,042335,Bagoli Talli,21,5,16,5,0,5,0,0,0,0,0,0,16,5,11
0017,042336,Lauegarh,5,4,1,3,3,0,0,0,0,1,1,0,1,0,1
0017,042337,Shiv Puri,32,6,26,29,4,25,0,0,0,0,0,0,3,2,1
0017,042338,Bam Siv,60,39,21,46,31,15,0,0,0,0,0,0,14,8,6
0017,042339,Gangu Laga Dunga,0,0,0,0,0,0,0,0,0,0,0,0,0,0,0
0017,042340,Dungra,36,19,17,16,6,10,0,0,0,0,0,0,20,13,7
0017,042341,Vara,26,21,5,14,11,3,0,0,0,0,0,0,12,10,2
0017,042342,Garh Khoon Lagatanthi,0,0,0,0,0,0,0,0,0,0,0,0,0,0,0
0017,042343,Chatora,25,20,5,7,6,1,0,0,0,0,0,0,18,14,4
0017,042344,Chauthala,16,14,2,13,12,1,0,0,0,0,0,0,3,2,1
0017,042345,Bagoli Malli,33,14,19,3,1,2,0,0,0,0,0,0,30,13,17
0017,042346,Dhamini,10,3,7,7,1,6,0,0,0,0,0,0,3,2,1
0017,042347,Khabar Sera,7,3,4,6,2,4,0,0,0,0,0,0,1,1,0
0017,042348,Molchada,24,8,16,20,5,15,0,0,0,0,0,0,4,3,1
0017,042349,Kathet Gaon,22,10,12,21,9,12,0,0,0,0,0,0,1,1,0
0017,042350,Batoli,24,1,23,23,0,23,0,0,0,0,0,0,1,1,0
0017,042351,Shri Kot Lagga Dugra,2,1,1,0,0,0,0,0,0,0,0,0,2,1,1
0017,042352,Janta,45,20,25,43,18,25,0,0,0,1,1,0,1,1,0
0017,042353,Deval Urf Bairagana,18,5,13,17,4,13,0,0,0,0,0,0,1,1,0
0017,042354,Sigawal Gaon,51,25,26,48,22,26,1,1,0,0,0,0,2,2,0
0017,042355,Kandai,15,11,4,0,0,0,0,0,0,1,0,1,14,11,3
0017,042356,Nau Gaon Singhwal Gaon,3,2,1,2,1,1,0,0,0,0,0,0,1,1,0
0017,042357,Dhingani,4,1,3,3,0,3,0,0,0,0,0,0,1,1,0
0017,042358,Nawasu,166,59,107,87,13,74,0,0,0,1,0,1,78,46,32
0017,042359,Moltha,1,1,0,0,0,0,0,0,0,0,0,0,1,1,0
0017,042360,Gahad,9,5,4,5,1,4,0,0,0,0,0,0,4,4,0
0017,042361,Juthanwas,102,30,72,76,11,65,0,0,0,0,0,0,26,19,7
0017,042362,Nauna,44,18,26,28,5,23,0,0,0,0,0,0,16,13,3
0017,042363,Dan Kot,85,37,48,69,23,46,1,0,1,2,2,0,13,12,1
0017,042364,Barsuri,15,10,5,1,0,1,4,1,3,0,0,0,10,9,1
0017,042365,Musyagaon,39,19,20,34,16,18,0,0,0,2,1,1,3,2,1
0017,042366,Kulatoli,0,0,0,0,0,0,0,0,0,0,0,0,0,0,0
0017,042367,Aak Sera,6,3,3,5,2,3,0,0,0,1,1,0,0,0,0
0017,042368,Mahendra Bagoli,87,33,54,79,28,51,0,0,0,1,1,0,7,4,3
0017,042369,Kamoldi,41,12,29,31,7,24,0,0,0,2,0,2,8,5,3
0017,042370,Pipli,35,22,13,23,14,9,1,0,1,0,0,0,11,8,3
0017,042371,Dobha Doblaga Kafoli,1,0,1,0,0,0,0,0,0,0,0,0,1,0,1
0017,042372,Sakhrori,97,32,65,91,26,65,0,0,0,1,1,0,5,5,0
0017,042373,Ban Gaon Talla,141,43,98,137,40,97,0,0,0,0,0,0,4,3,1
0017,042374,Dhar Kot,98,29,69,96,27,69,0,0,0,0,0,0,2,2,0
0017,042375,Syoni,78,26,52,68,20,48,0,0,0,0,0,0,10,6,4
0017,042376,Shyal Khet,25,10,15,22,10,12,1,0,1,0,0,0,2,0,2
0017,042377,Koli,250,93,157,22,22,0,1,1,0,211,54,157,16,16,0
0017,042378,Surari,101,42,59,81,30,51,0,0,0,3,0,3,17,12,5
0017,042379,Thendi,102,35,67,86,23,63,1,1,0,0,0,0,15,11,4
0017,042380,Jutai,75,25,50,71,22,49,1,0,1,0,0,0,3,3,0
0017,042381,Margaon ,150,56,94,110,37,73,1,0,1,1,1,0,38,18,20
0017,042382,Afrai Khet,36,14,22,30,8,22,0,0,0,0,0,0,6,6,0
0017,042383,Dhankot/ Kandadhar,8,8,0,3,3,0,0,0,0,3,3,0,2,2,0
0017,042384,Naukhu,36,19,17,24,8,16,0,0,0,0,0,0,12,11,1
0017,042385,Baneta Laga Syuni,0,0,0,0,0,0,0,0,0,0,0,0,0,0,0
0017,042386,Barkot,17,7,10,9,1,8,0,0,0,0,0,0,8,6,2
0017,042387,Pata,66,38,28,16,7,9,48,30,18,0,0,0,2,1,1
0017,042388,Bansue,212,72,140,203,65,138,0,0,0,0,0,0,9,7,2
0017,042389,Nakar,2,0,2,2,0,2,0,0,0,0,0,0,0,0,0
0017,042390,Ban Gaon Malla,66,30,36,65,29,36,0,0,0,0,0,0,1,1,0
0017,042391,Jundoli,132,49,83,114,37,77,0,0,0,2,1,1,16,11,5
0017,042405,Bhains Gaon,9,8,1,1,1,0,0,0,0,0,0,0,8,7,1
0017,042406,Pola,7,6,1,0,0,0,0,0,0,1,1,0,6,5,1
0017,042407,Nari,261,84,177,224,50,174,0,0,0,3,3,0,34,31,3
0017,042408,Syund Dhamak,8,6,2,0,0,0,0,0,0,2,2,0,6,4,2
0017,042409,Satera,149,107,42,138,102,36,1,0,1,3,2,1,7,3,4
0017,042410,Shyupuri,292,163,129,187,77,110,3,2,1,0,0,0,102,84,18
0017,042411,Khatyana,134,39,95,121,31,90,1,0,1,1,1,0,11,7,4
0017,042412,Bauthal Laga Khatyana,69,31,38,61,24,37,0,0,0,2,2,0,6,5,1
0017,042413,Sandar,33,28,5,4,2,2,0,0,0,1,1,0,28,25,3
0017,042414,Kando Laga Darmbari,0,0,0,0,0,0,0,0,0,0,0,0,0,0,0
0017,042415,Darmwari,16,12,4,0,0,0,0,0,0,0,0,0,16,12,4
0017,042416,Kyark Nandala,51,16,35,38,10,28,1,0,1,0,0,0,12,6,6
0017,042417,San,67,22,45,47,5,42,0,0,0,1,1,0,19,16,3
0017,042418,Dhaulsari,82,34,48,75,29,46,2,1,1,1,1,0,4,3,1
0017,042419,Amdala,87,36,51,81,30,51,0,0,0,0,0,0,6,6,0
0017,042420,Dhureli,49,24,25,45,21,24,1,0,1,0,0,0,3,3,0
0017,042421,Kameda,123,23,100,100,5,95,0,0,0,0,0,0,23,18,5
0017,042422,Benji,7,7,0,0,0,0,0,0,0,0,0,0,7,7,0
0017,042423,Gangtal,88,63,25,28,6,22,0,0,0,0,0,0,60,57,3
0017,042424,Dangi,31,13,18,19,5,14,1,0,1,1,1,0,10,7,3
0017,042425,Rampur,74,57,17,10,1,9,0,0,0,8,8,0,56,48,8
0017,042426,Gir Bhuter,228,195,33,15,12,3,0,0,0,42,40,2,171,143,28
0017,042427,Tilwara,61,47,14,7,3,4,0,0,0,5,4,1,49,40,9
0017,042428,Methana Chhitoli,242,105,137,5,2,3,174,54,120,16,12,4,47,37,10
0017,042429,Tamind,51,15,36,43,8,35,0,0,0,1,1,0,7,6,1
0017,042430,Chauki Barsil,4,4,0,1,1,0,1,1,0,0,0,0,2,2,0
0017,042431,Karndhar,48,14,34,43,9,34,0,0,0,0,0,0,5,5,0
0017,042432,Gunaun,12,11,1,0,0,0,0,0,0,0,0,0,12,11,1
0017,042433,Chopra,49,10,39,46,7,39,0,0,0,0,0,0,3,3,0
0017,042434,Saurbhat Gaon,231,100,131,200,76,124,0,0,0,0,0,0,31,24,7
0017,042435,Bandrikot,36,9,27,32,5,27,0,0,0,0,0,0,4,4,0
0017,042436,Tolib,50,46,4,40,38,2,0,0,0,1,1,0,9,7,2
0017,042437,Kumoli Malkoti,168,78,90,90,32,58,26,9,17,22,13,9,30,24,6
0017,042438,Bawai,549,205,344,421,110,311,1,1,0,2,1,1,125,93,32
0017,042439,Bamoli,20,9,11,13,2,11,0,0,0,0,0,0,7,7,0
0017,042440,Maikoti,170,56,114,133,26,107,0,0,0,1,1,0,36,29,7
0017,042441,Thalasu,100,48,52,65,18,47,4,2,2,1,1,0,30,27,3
0017,042442,Barsil Pawek,35,13,22,25,4,21,0,0,0,0,0,0,10,9,1
0017,042443,Chamak,203,102,101,131,44,87,3,1,2,5,1,4,64,56,8
0017,042444,Saury,142,61,81,107,40,67,2,1,1,20,10,10,13,10,3
0017,042445,Silkot,1,0,1,0,0,0,0,0,0,0,0,0,1,0,1
0017,042446,Chameli,94,46,48,12,4,8,74,36,38,0,0,0,8,6,2
0017,042447,Amotha,61,43,18,2,1,1,6,4,2,4,1,3,49,37,12
0017,042448,Baniyari,138,98,40,2,1,1,2,1,1,5,4,1,129,92,37
0017,042449,Nakot,915,698,217,133,68,65,2,0,2,19,17,2,761,613,148
0017,042450,Bhausal,4,2,2,3,2,1,0,0,0,0,0,0,1,0,1
0017,042451,Rumsi,42,23,19,36,17,19,0,0,0,0,0,0,6,6,0
0017,042452,Bareth,3,2,1,0,0,0,0,0,0,0,0,0,3,2,1
0017,042453,Malkhi,51,31,20,0,0,0,15,13,2,0,0,0,36,18,18
0017,042454,Bhatwari,29,21,8,5,4,1,0,0,0,0,0,0,24,17,7
0017,042455,Managu,38,36,2,3,3,0,4,4,0,0,0,0,31,29,2
0017,042456,Khalyo,6,6,0,1,1,0,0,0,0,0,0,0,5,5,0
0017,042457,Syal Dobha,3,3,0,0,0,0,0,0,0,0,0,0,3,3,0
0017,042458,Silli Sera,63,46,17,8,2,6,0,0,0,1,1,0,54,43,11
0017,042459,Dobha,31,28,3,18,17,1,0,0,0,1,1,0,12,10,2
0017,042460,Chond,15,9,6,13,7,6,0,0,0,0,0,0,2,2,0
0017,042461,Bhatwari,37,13,24,30,7,23,0,0,0,0,0,0,7,6,1
0017,042462,Urkholi,50,22,28,43,16,27,0,0,0,0,0,0,7,6,1
0017,042463,Swari Gwans,415,178,237,365,133,232,3,0,3,1,1,0,46,44,2
0017,042464,Ghimtoli,92,51,41,54,17,37,7,7,0,1,1,0,30,26,4
0017,042465,Kollu Bhannu,12,9,3,5,3,2,0,0,0,0,0,0,7,6,1
0017,042466,Bachhani,67,27,40,55,21,34,0,0,0,6,2,4,6,4,2
0017,042467,Gadil,24,14,10,10,2,8,0,0,0,3,3,0,11,9,2
0017,042468,Phalasi,124,63,61,93,40,53,1,0,1,8,7,1,22,16,6
0017,042469,Bora,153,46,107,143,37,106,3,2,1,0,0,0,7,7,0
0017,042470,Gorna,149,48,101,99,7,92,0,0,0,0,0,0,50,41,9
0017,042471,Malnaun,95,29,66,78,16,62,0,0,0,0,0,0,17,13,4
0017,042472,Kunda Dankot,413,178,235,316,101,215,1,0,1,4,2,2,92,75,17
0017,042473,Tarag,55,40,15,14,8,6,13,6,7,1,1,0,27,25,2
0017,042474,Kanda,22,16,6,9,4,5,0,0,0,2,2,0,11,10,1
0017,042475,Kyuri,182,137,45,86,47,39,5,4,1,13,13,0,78,73,5
0017,042476,Lodala,86,30,56,79,26,53,2,0,2,0,0,0,5,4,1
0017,042477,Gadsari,1,0,1,1,0,1,0,0,0,0,0,0,0,0,0
0017,042478,Baridang,0,0,0,0,0,0,0,0,0,0,0,0,0,0,0
0017,042479,Jakhni,206,83,123,137,27,110,2,2,0,0,0,0,67,54,13
0017,042480,Chamswara,156,63,93,131,44,87,0,0,0,0,0,0,25,19,6
0017,042481,Patal Laga Kothagi,0,0,0,0,0,0,0,0,0,0,0,0,0,0,0
0017,042482,Gadmil,118,28,90,94,8,86,0,0,0,0,0,0,24,20,4
0017,042483,Semal Sari,12,8,4,2,0,2,0,0,0,0,0,0,10,8,2
0017,042484,Chapar,130,22,108,107,10,97,0,0,0,0,0,0,23,12,11
0017,042485,Dungari,86,76,10,72,66,6,0,0,0,0,0,0,14,10,4
0017,042486,Bajyun,112,39,73,91,21,70,0,0,0,0,0,0,21,18,3
0017,042487,Utarasu,84,29,55,71,18,53,1,0,1,0,0,0,12,11,1
0017,042488,Jondala,79,34,45,68,23,45,0,0,0,3,3,0,8,8,0
0017,042489,Temana,21,6,15,15,0,15,0,0,0,0,0,0,6,6,0
0017,042490,Pali Jaikhanda,45,23,22,28,6,22,0,0,0,0,0,0,17,17,0
0017,042491,Dewlakh,33,26,7,3,0,3,0,0,0,0,0,0,30,26,4
0017,042492,Sarqu,24,21,3,7,6,1,0,0,0,0,0,0,17,15,2
0017,042493,Gandhari,206,86,120,172,56,116,2,2,0,0,0,0,32,28,4
0017,042494,Bhainsari,39,11,28,38,11,27,0,0,0,0,0,0,1,0,1
0017,042495,Pali Talli,27,23,4,0,0,0,0,0,0,0,0,0,27,23,4
0017,042496,Pali Malli,7,6,1,0,0,0,0,0,0,0,0,0,7,6,1
0017,042497,Chopara,46,36,10,1,1,0,0,0,0,0,0,0,45,35,10
0017,042498,Kurjhan,23,17,6,3,1,2,0,0,0,0,0,0,20,16,4
0017,042499,Kwili,200,68,132,189,61,128,0,0,0,2,1,1,9,6,3
0017,042500,Dharkot,57,28,29,50,25,25,0,0,0,1,1,0,6,2,4
0017,042501,Bhair Gaon,5,3,2,0,0,0,0,0,0,0,0,0,5,3,2
0017,042502,Nirwali,38,14,24,33,11,22,0,0,0,0,0,0,5,3,2
0017,042503,Jhirmoli,12,10,2,6,4,2,0,0,0,0,0,0,6,6,0
0017,042504,Punar,201,110,91,43,20,23,12,2,10,1,1,0,145,87,58
0017,042505,Barsu,4,0,4,4,0,4,0,0,0,0,0,0,0,0,0
0017,042506,Toona,137,63,74,65,1,64,0,0,0,1,1,0,71,61,10
0017,042507,Gwar Thapali,25,19,6,1,0,1,0,0,0,0,0,0,24,19,5
0017,042508,Lameri,92,27,65,82,18,64,1,1,0,0,0,0,9,8,1
0017,042509,Tilani,4,4,0,0,0,0,0,0,0,0,0,0,4,4,0
0017,042510,Sumerpur,14,6,8,7,2,5,0,0,0,0,0,0,7,4,3
0017,042511,Dungri,15,13,2,10,8,2,0,0,0,0,0,0,5,5,0
0017,042512,Lugai,3,3,0,0,0,0,0,0,0,0,0,0,3,3,0
0017,042513,Ratura,272,239,33,63,49,14,1,0,1,0,0,0,208,190,18
0017,042514,Dhartoli,9,4,5,8,3,5,0,0,0,0,0,0,1,1,0
0017,042515,Pokhari,123,58,65,109,47,62,1,0,1,0,0,0,13,11,2
0017,042516,Gadora,43,35,8,26,23,3,0,0,0,1,1,0,16,11,5
0017,042517,Bankhil,32,11,21,29,8,21,0,0,0,0,0,0,3,3,0
0017,042518,Kalana,14,9,5,6,2,4,0,0,0,0,0,0,8,7,1
0017,042519,Saur Laga Kalna,3,3,0,0,0,0,0,0,0,0,0,0,3,3,0
0017,042520,Shiwnandi,37,17,20,32,12,20,0,0,0,1,1,0,4,4,0
0017,042521,Chiwai,32,14,18,30,13,17,0,0,0,0,0,0,2,1,1
0017,042522,Simtoli,104,30,74,90,19,71,3,2,1,1,1,0,10,8,2
0017,042523,Kanda,54,18,36,48,14,34,0,0,0,1,1,0,5,3,2
0017,042524,Bhunka Walla,6,6,0,3,3,0,0,0,0,0,0,0,3,3,0
0017,042525,Dhadhad Chak,58,30,28,56,28,28,0,0,0,0,0,0,2,2,0
0017,042526,Gwapher,19,16,3,0,0,0,0,0,0,0,0,0,19,16,3
0017,042527,Kyarki,9,5,4,0,0,0,0,0,0,0,0,0,9,5,4
0017,042528,Sweensera,0,0,0,0,0,0,0,0,0,0,0,0,0,0,0
0017,042529,Khari,5,4,1,0,0,0,0,0,0,0,0,0,5,4,1
0017,042530,Ghandiyalka,7,5,2,0,0,0,0,0,0,0,0,0,7,5,2
0017,042531,Beeron,38,34,4,1,1,0,1,1,0,0,0,0,36,32,4
0017,042532,Loli,84,34,50,69,22,47,7,7,0,1,1,0,7,4,3
0017,042533,Chwinth,17,17,0,1,1,0,0,0,0,6,6,0,10,10,0
0017,042534,Ranigarh,0,0,0,0,0,0,0,0,0,0,0,0,0,0,0
0017,042535,Gwar Laga Punar,9,7,2,0,0,0,0,0,0,0,0,0,9,7,2
0017,042536,Chin Gwar,19,12,7,3,1,2,0,0,0,0,0,0,16,11,5
0017,042537,Peera,182,46,136,113,8,105,0,0,0,29,9,20,40,29,11
0017,042538,Paboun,5,2,3,1,1,0,0,0,0,0,0,0,4,1,3
0017,042539,Khair Pani,10,2,8,7,1,6,0,0,0,3,1,2,0,0,0
0017,042540,Bhunka Palla,12,9,3,6,4,2,0,0,0,0,0,0,6,5,1
0017,042541,Agar Jawari,33,28,5,0,0,0,0,0,0,1,0,1,32,28,4
0017,042542,Talgad,88,29,59,81,25,56,0,0,0,0,0,0,7,4,3
0017,042543,Kyudi Malansh,272,115,157,271,114,157,0,0,0,0,0,0,1,1,0
0017,042544,Dhung,11,10,1,1,1,0,0,0,0,1,1,0,9,8,1
0017,042545,Jarmwar,120,43,77,117,42,75,0,0,0,0,0,0,3,1,2
0017,042546,Kokhandi,162,48,114,156,45,111,1,1,0,0,0,0,5,2,3
0017,042547,Kandai Bainji,29,28,1,2,1,1,2,2,0,0,0,0,25,25,0
0017,042548,Mahar Talla,13,3,10,12,2,10,0,0,0,0,0,0,1,1,0
0017,042549,Thapal Gaon,68,58,10,7,5,2,2,2,0,2,2,0,57,49,8
0017,042550,Bora Malla,1,1,0,0,0,0,0,0,0,0,0,0,1,1,0
0017,042551,Mahar Malla,26,9,17,15,3,12,0,0,0,0,0,0,11,6,5
0017,042552,Jangi Kandai,248,116,132,212,80,132,0,0,0,4,4,0,32,32,0
0017,042553,Baman Thapal,25,19,6,4,2,2,0,0,0,2,2,0,19,15,4
0017,042554,Isala,41,41,0,7,7,0,0,0,0,3,3,0,31,31,0
0017,042555,Bora Talla,4,0,4,3,0,3,0,0,0,0,0,0,1,0,1
0017,042556,Bijarakot,26,19,7,0,0,0,0,0,0,0,0,0,26,19,7
0017,042557,Gair Laga Bijarakot,0,0,0,0,0,0,0,0,0,0,0,0,0,0,0
0017,042558,Gwar Laga Bijarakot,0,0,0,0,0,0,0,0,0,0,0,0,0,0,0
0017,042559,Nagdanda,14,8,6,6,2,4,0,0,0,0,0,0,8,6,2
0017,042560,Sari,51,45,6,2,2,0,0,0,0,0,0,0,49,43,6
0017,042561,Chamsil,2,2,0,1,1,0,0,0,0,0,0,0,1,1,0
0017,042562,Jhalimath,2,2,0,0,0,0,0,0,0,0,0,0,2,2,0
0017,042563,Sindarwani Malli,16,14,2,4,3,1,0,0,0,0,0,0,12,11,1
0017,042564,Narsu Lagasari,1,1,0,0,0,0,0,0,0,0,0,0,1,1,0
0017,042565,Nag Lagasari,6,6,0,1,1,0,0,0,0,0,0,0,5,5,0
0017,042566,Sindarwani Talli,66,40,26,38,18,20,0,0,0,1,1,0,27,21,6
0017,042567,Chhinka,155,55,100,131,37,94,0,0,0,0,0,0,24,18,6
0017,042568,Kothagi,38,33,5,2,1,1,0,0,0,10,10,0,26,22,4
0017,042569,Madola,99,71,28,32,12,20,5,2,3,1,0,1,61,57,4
0017,042570,Bhatwari,101,34,67,76,15,61,1,0,1,0,0,0,24,19,5
0017,042571,Koti Barkoti,3,3,0,0,0,0,0,0,0,0,0,0,3,3,0
0017,042572,Dobh Laga Marora,45,18,27,28,2,26,0,0,0,6,6,0,11,10,1
0017,042573,Marora,93,54,39,39,4,35,0,0,0,8,8,0,46,42,4
0017,042574,Mawana,514,285,229,312,114,198,2,1,1,23,22,1,177,148,29
0017,042575,Nagrasu,274,134,140,100,51,49,62,25,37,23,7,16,89,51,38
0017,042576,Bhat Gaon,83,23,60,64,7,57,0,0,0,1,1,0,18,15,3
0017,042577,Beena,49,21,28,39,13,26,0,0,0,0,0,0,10,8,2
0017,042578,Kot Malla,13,12,1,9,8,1,0,0,0,0,0,0,4,4,0
0017,042579,Ghiroli,16,8,8,12,4,8,0,0,0,0,0,0,4,4,0
0017,042580,Kot Talla,14,9,5,12,8,4,0,0,0,0,0,0,2,1,1
0017,042581,Kharkota,4,1,3,3,0,3,0,0,0,0,0,0,1,1,0
0017,042582,Jasoli,51,36,15,13,5,8,0,0,0,0,0,0,38,31,7
0017,042583,Tolgaon,18,10,8,0,0,0,11,3,8,0,0,0,7,7,0
0017,042584,Kodima,18,12,6,9,5,4,0,0,0,1,1,0,8,6,2
0017,042585,Langala Lagaladoli,0,0,0,0,0,0,0,0,0,0,0,0,0,0,0
0017,042586,Mola,41,15,26,34,8,26,0,0,0,0,0,0,7,7,0
0017,042587,Chori Laga Ghorsal,0,0,0,0,0,0,0,0,0,0,0,0,0,0,0
0017,042588,Sitakoti,0,0,0,0,0,0,0,0,0,0,0,0,0,0,0
0017,042589,Diwli,92,37,55,68,15,53,2,2,0,2,2,0,20,18,2
0017,042590,Ladoli,57,44,13,9,3,6,0,0,0,0,0,0,48,41,7
0017,042591,Kwali,45,17,28,29,3,26,1,1,0,0,0,0,15,13,2
0017,042592,Toriyal,34,10,24,32,8,24,0,0,0,0,0,0,2,2,0
0017,042593,Ghorsal,56,16,40,48,8,40,0,0,0,1,1,0,7,7,0
0017,042594,Gadboo,31,9,22,27,5,22,0,0,0,1,1,0,3,3,0
0017,042595,Raintoli,78,36,42,78,36,42,0,0,0,0,0,0,0,0,0
0018,000000,Jakholi,25437,10843,14594,21092,7347,13745,261,142,119,190,157,33,3894,3197,697
0018,000000,Jakholi,25437,10843,14594,21092,7347,13745,261,142,119,190,157,33,3894,3197,697
0018,000000,Jakholi,0,0,0,0,0,0,0,0,0,0,0,0,0,0,0
0018,042302,Mosar,8,7,1,1,1,0,0,0,0,0,0,0,7,6,1
0018,042303,Mahar Gaon,5,3,2,1,0,1,0,0,0,0,0,0,4,3,1
0018,042304,Math Gaon,214,61,153,207,58,149,0,0,0,1,0,1,6,3,3
0018,042305,Saunda,409,151,258,387,132,255,0,0,0,0,0,0,22,19,3
0018,042306,Sakanyana,98,34,64,69,8,61,4,4,0,3,3,0,22,19,3
0018,042307,Thapala,22,1,21,21,1,20,0,0,0,0,0,0,1,0,1
0018,042308,Timali,159,57,102,146,48,98,2,1,1,4,4,0,7,4,3
0018,042309,Dhaunda,41,24,17,0,0,0,19,9,10,2,2,0,20,13,7
0018,042310,Chaura Sirai,10,9,1,1,1,0,0,0,0,0,0,0,9,8,1
0018,042311,Bhyuta,18,13,5,0,0,0,0,0,0,1,1,0,17,12,5
0018,042312,Kaphna,154,58,96,138,46,92,0,0,0,0,0,0,16,12,4
0018,042313,Saurakhal,37,32,5,2,1,1,1,1,0,6,6,0,28,24,4
0018,042314,Satani,41,31,10,1,1,0,0,0,0,2,2,0,38,28,10
0018,042315,Syari,6,3,3,0,0,0,0,0,0,1,1,0,5,2,3
0018,042316,Khargad,22,18,4,0,0,0,0,0,0,0,0,0,22,18,4
0018,042317,Bansi,162,72,90,125,46,79,3,1,2,0,0,0,34,25,9
0018,042318,Sera,13,13,0,0,0,0,1,1,0,0,0,0,12,12,0
0018,042319,Paparasu,3,2,1,0,0,0,0,0,0,0,0,0,3,2,1
0018,042392,Semalta,34,15,19,26,10,16,0,0,0,0,0,0,8,5,3
0018,042393,Gawana,33,20,13,11,2,9,1,0,1,0,0,0,21,18,3
0018,042394,Dungari,99,29,70,98,28,70,0,0,0,0,0,0,1,1,0
0018,042395,Swili,29,6,23,23,0,23,0,0,0,0,0,0,6,6,0
0018,042396,Lendar Urf Sem,49,17,32,21,1,20,11,0,11,0,0,0,17,16,1
0018,042397,Tarwari,35,32,3,31,29,2,0,0,0,0,0,0,4,3,1
0018,042398,Jawari,606,274,332,567,245,322,2,2,0,4,4,0,33,23,10
0018,042399,Dharmola,272,116,156,181,39,142,0,0,0,0,0,0,91,77,14
0018,042400,Dungra,65,12,53,61,9,52,0,0,0,0,0,0,4,3,1
0018,042401,Routhiya,316,188,128,121,5,116,0,0,0,1,1,0,194,182,12
0018,042402,Kotali,142,74,68,132,69,63,9,4,5,1,1,0,0,0,0
0018,042403,Malyasu Talla,47,25,22,32,11,21,0,0,0,4,3,1,11,11,0
0018,042404,Malyasu Malla,0,0,0,0,0,0,0,0,0,0,0,0,0,0,0
0018,042604,Pala Kurali,345,109,236,327,95,232,0,0,0,0,0,0,18,14,4
0018,042605,Uchhana,295,96,199,291,93,198,0,0,0,0,0,0,4,3,1
0018,042606,Goti,284,121,163,253,97,156,0,0,0,0,0,0,31,24,7
0018,042607,Uroli,194,58,136,182,50,132,0,0,0,0,0,0,12,8,4
0018,042608,Dhan Kurali,109,33,76,105,29,76,0,0,0,1,1,0,3,3,0
0018,042609,Bajira,215,101,114,199,85,114,0,0,0,0,0,0,16,16,0
0018,042610,Syal Dhuri,6,2,4,6,2,4,0,0,0,0,0,0,0,0,0
0018,042611,Mamani,102,31,71,96,29,67,0,0,0,0,0,0,6,2,4
0018,042612,Dhanyau,2,2,0,0,0,0,0,0,0,1,1,0,1,1,0
0018,042613,Budna,853,306,547,652,140,512,13,10,3,7,3,4,181,153,28
0018,042614,Mahargoan,102,36,66,81,24,57,6,2,4,2,0,2,13,10,3
0018,042615,Jakholi,197,82,115,106,2,104,1,1,0,0,0,0,90,79,11
0018,042616,Bachwar,147,42,105,117,19,98,0,0,0,1,0,1,29,23,6
0018,042617,Paurjuli,72,22,50,65,17,48,4,3,1,0,0,0,3,2,1
0018,042618,Sirahi,39,14,25,36,11,25,0,0,0,0,0,0,3,3,0
0018,042619,Barsir,299,110,189,252,75,177,0,0,0,0,0,0,47,35,12
0018,042620,Chandi,140,52,88,130,47,83,0,0,0,0,0,0,10,5,5
0018,042621,Kothiyara,141,60,81,121,43,78,0,0,0,0,0,0,20,17,3
0018,042622,Kapaniya,277,102,175,202,41,161,1,1,0,0,0,0,74,60,14
0018,042623,Laluri,82,60,22,10,3,7,6,3,3,1,1,0,65,53,12
0018,042624,Dewal,146,60,86,142,58,84,0,0,0,1,1,0,3,1,2
0018,042625,Lamwar,41,15,26,38,12,26,0,0,0,0,0,0,3,3,0
0018,042626,Dharada,96,40,56,52,1,51,0,0,0,0,0,0,44,39,5
0018,042627,Koti,187,72,115,185,72,113,0,0,0,0,0,0,2,0,2
0018,042628,Luthiyag,148,29,119,124,14,110,3,1,2,11,10,1,10,4,6
0018,042629,Tyunkhar,1009,505,504,988,490,498,1,0,1,0,0,0,20,15,5
0018,042630,Makhet,228,85,143,134,6,128,0,0,0,0,0,0,94,79,15
0018,042631,Mayali,345,145,200,218,63,155,0,0,0,0,0,0,127,82,45
0018,042632,Jakhani,143,60,83,93,14,79,0,0,0,0,0,0,50,46,4
0018,042633,Lauga,55,48,7,0,0,0,0,0,0,13,11,2,42,37,5
0018,042634,Sakalana,130,57,73,123,55,68,1,0,1,0,0,0,6,2,4
0018,042635,Badhani,180,64,116,172,57,115,0,0,0,0,0,0,8,7,1
0018,042636,Jagtoli,32,10,22,31,9,22,0,0,0,0,0,0,1,1,0
0018,042637,Gethana,209,43,166,204,39,165,1,1,0,0,0,0,4,3,1
0018,042638,Dhar Kuri,247,79,168,244,76,168,0,0,0,1,1,0,2,2,0
0018,042639,Kot,246,102,144,219,86,133,0,0,0,0,0,0,27,16,11
0018,042640,San,218,88,130,213,86,127,0,0,0,1,1,0,4,1,3
0018,042641,Sirwadi,12,11,1,3,2,1,0,0,0,3,3,0,6,6,0
0018,042642,Jakhawari Malli,207,79,128,200,74,126,0,0,0,1,1,0,6,4,2
0018,042643,Liswalta,204,54,150,195,48,147,0,0,0,0,0,0,9,6,3
0018,042644,Khaliyan,38,31,7,3,2,1,0,0,0,0,0,0,35,29,6
0018,042645,Jakhawari Talli,23,19,4,10,8,2,0,0,0,0,0,0,13,11,2
0018,042646,Pujar Gaon,27,27,0,0,0,0,0,0,0,0,0,0,27,27,0
0018,042647,Pulan,439,219,220,411,197,214,0,0,0,1,0,1,27,22,5
0018,042648,Munyadhar,30,14,16,30,14,16,0,0,0,0,0,0,0,0,0
0018,042649,Pauthi,707,215,492,671,188,483,4,0,4,8,7,1,24,20,4
0018,042650,Bhatwari,259,92,167,253,89,164,0,0,0,0,0,0,6,3,3
0018,042651,Chopara,166,52,114,152,46,106,3,1,2,7,1,6,4,4,0
0018,042652,Nandawan Gaon,81,30,51,71,27,44,0,0,0,0,0,0,10,3,7
0018,042653,Chaura,195,82,113,162,55,107,0,0,0,0,0,0,33,27,6
0018,042654,Kandiyali,91,31,60,89,29,60,0,0,0,0,0,0,2,2,0
0018,042655,Panjana,208,85,123,157,41,116,0,0,0,0,0,0,51,44,7
0018,042656,Uroli,42,16,26,30,4,26,0,0,0,0,0,0,12,12,0
0018,042657,Kurchholi,14,5,9,3,0,3,0,0,0,1,0,1,10,5,5
0018,042658,Rahar,51,26,25,40,17,23,0,0,0,0,0,0,11,9,2
0018,042659,Khal,15,6,9,14,6,8,0,0,0,0,0,0,1,0,1
0018,042660,Bagjiwala,15,6,9,11,2,9,0,0,0,0,0,0,4,4,0
0018,042661,Nag,8,7,1,1,0,1,0,0,0,0,0,0,7,7,0
0018,042662,Purwana,2,2,0,0,0,0,0,0,0,1,1,0,1,1,0
0018,042663,Dharkot,349,151,198,334,142,192,6,3,3,3,2,1,6,4,2
0018,042664,Atholi,11,8,3,7,6,1,0,0,0,0,0,0,4,2,2
0018,042665,Bharnga,196,94,102,181,85,96,7,3,4,3,2,1,5,4,1
0018,042666,Palot,84,22,62,76,15,61,0,0,0,0,0,0,8,7,1
0018,042667,Bainoli,69,43,26,54,34,20,0,0,0,0,0,0,15,9,6
0018,042668,Barshot,28,9,19,27,8,19,0,0,0,1,1,0,0,0,0
0018,042669,Biran Goan,48,12,36,45,9,36,0,0,0,0,0,0,3,3,0
0018,042670,Tuneta,139,58,81,106,32,74,0,0,0,0,0,0,33,26,7
0018,042671,Tariyal Gaon,108,55,53,100,49,51,0,0,0,1,1,0,7,5,2
0018,042672,Lariyasyu,95,43,52,87,38,49,0,0,0,0,0,0,8,5,3
0018,042673,Sema,210,83,127,133,18,115,0,0,0,1,0,1,76,65,11
0018,042674,Subhani Sumari,468,281,187,253,98,155,0,0,0,0,0,0,215,183,32
0018,042675,Lekh Lawari,129,58,71,67,0,67,1,1,0,0,0,0,61,57,4
0018,042676,Hariyali,141,47,94,119,27,92,1,1,0,4,4,0,17,15,2
0018,042677,Dangi,28,25,3,19,19,0,0,0,0,0,0,0,9,6,3
0018,042678,Jakholi Talli,1,1,0,0,0,0,0,0,0,0,0,0,1,1,0
0018,042679,Doma Jakhal,267,88,179,261,83,178,0,0,0,0,0,0,6,5,1
0018,042680,Srikot,55,21,34,49,19,30,0,0,0,0,0,0,6,2,4
0018,042681,Udiyan Gaon,69,63,6,59,59,0,0,0,0,3,3,0,7,1,6
0018,042682,Kot,64,13,51,61,11,50,0,0,0,0,0,0,3,2,1
0018,042683,Dhariyana,102,20,82,97,17,80,0,0,0,0,0,0,5,3,2
0018,042684,Jakholi Malli,13,12,1,3,3,0,1,1,0,0,0,0,9,8,1
0018,042685,Naouli,21,14,7,6,4,2,0,0,0,0,0,0,15,10,5
0018,042686,Sil Gaon,70,41,29,66,38,28,0,0,0,0,0,0,4,3,1
0018,042687,Kwila,60,32,28,30,4,26,0,0,0,0,0,0,30,28,2
0018,042688,Kanda,270,99,171,267,98,169,0,0,0,0,0,0,3,1,2
0018,042689,Pingari,58,22,36,53,18,35,0,0,0,0,0,0,5,4,1
0018,042690,Ratanpur,95,32,63,81,19,62,0,0,0,0,0,0,14,13,1
0018,042691,Ghegar,510,171,339,485,151,334,0,0,0,0,0,0,25,20,5
0018,042692,Medanpur,142,37,105,130,29,101,0,0,0,0,0,0,12,8,4
0018,042693,Mawan Gaon,188,87,101,167,72,95,0,0,0,0,0,0,21,15,6
0018,042694,Barsari,32,20,12,19,7,12,0,0,0,0,0,0,13,13,0
0018,042695,Talla,386,202,184,195,21,174,0,0,0,0,0,0,191,181,10
0018,042696,Jakhatoli,77,58,19,57,40,17,0,0,0,0,0,0,20,18,2
0018,042697,Tat,66,62,4,34,32,2,2,2,0,4,4,0,26,24,2
0018,042698,Dhankuri,0,0,0,0,0,0,0,0,0,0,0,0,0,0,0
0018,042699,Musa Dung,345,119,226,331,108,223,0,0,0,0,0,0,14,11,3
0018,042700,Pali,136,52,84,111,37,74,0,0,0,0,0,0,25,15,10
0018,042701,Jaili,139,49,90,120,36,84,0,0,0,2,2,0,17,11,6
0018,042702,Kandali,271,129,142,244,114,130,1,1,0,0,0,0,26,14,12
0018,042703,Bhimali,117,37,80,88,12,76,1,1,0,19,18,1,9,6,3
0018,042704,Sisau,7,6,1,1,1,0,0,0,0,0,0,0,6,5,1
0018,042705,Mar Gaon,29,18,11,5,1,4,0,0,0,3,2,1,21,15,6
0018,042706,Kumari,371,162,209,344,146,198,3,0,3,7,4,3,17,12,5
0018,042707,Phalati,125,72,53,106,56,50,0,0,0,0,0,0,19,16,3
0018,042708,Chaka,248,112,136,204,72,132,0,0,0,0,0,0,44,40,4
0018,042709,Dhariyaj,123,44,79,93,17,76,0,0,0,2,2,0,28,25,3
0018,042710,Kirora Talla,173,68,105,157,54,103,3,3,0,7,7,0,6,4,2
0018,042711,Kirora Malla,236,79,157,230,75,155,0,0,0,0,0,0,6,4,2
0018,042712,Utarsu,25,18,7,3,1,2,2,1,1,0,0,0,20,16,4
0018,042713,Marora,92,52,40,83,45,38,1,1,0,1,1,0,7,5,2
0018,042714,Sem,114,46,68,92,28,64,3,3,0,1,1,0,18,14,4
0018,042715,Thati,94,38,56,71,17,54,1,1,0,1,1,0,21,19,2
0018,042716,Munnadewal,35,27,8,5,2,3,3,1,2,2,2,0,25,22,3
0018,042717,Jakholi,231,107,124,137,33,104,1,1,0,5,5,0,88,68,20
0018,042718,Dangwal Gaon,437,228,209,364,182,182,44,22,22,2,2,0,27,22,5
0018,042719,Ghanat Gaon,165,84,81,133,56,77,0,0,0,4,4,0,28,24,4
0018,042720,Koti,82,43,39,65,28,37,2,2,0,1,1,0,14,12,2
0018,042721,Dovalya,81,46,35,55,23,32,0,0,0,0,0,0,26,23,3
0018,042722,Basta,24,17,7,8,7,1,0,0,0,9,7,2,7,3,4
0018,042723,Dobh,189,64,125,171,49,122,0,0,0,0,0,0,18,15,3
0018,042724,Kuri Aduli,246,98,148,170,35,135,2,0,2,1,0,1,73,63,10
0018,042725,Lukhundri,4,2,2,2,1,1,0,0,0,0,0,0,2,1,1
0018,042726,Jakhanyal Gaon,77,23,54,66,13,53,0,0,0,0,0,0,11,10,1
0018,042727,Gair Sera,2,1,1,2,1,1,0,0,0,0,0,0,0,0,0
0018,042728,Patiyon,45,17,28,36,9,27,0,0,0,0,0,0,9,8,1
0018,042729,Khor,241,88,153,202,57,145,3,0,3,5,5,0,31,26,5
0018,042730,Dangi,83,25,58,49,3,46,7,0,7,0,0,0,27,22,5
0018,042731,Bag Seer,126,110,16,121,105,16,0,0,0,0,0,0,5,5,0
0018,042732,Bhunal Gaon,507,268,239,505,267,238,0,0,0,1,1,0,1,0,1
0018,042733,Mathya Gaon,152,77,75,110,51,59,19,9,10,3,2,1,20,15,5
0018,042734,Uchhola,396,172,224,389,169,220,0,0,0,0,0,0,7,3,4
0018,042735,Syur,673,308,365,635,273,362,1,1,0,0,0,0,37,34,3
0018,042736,Kimana,34,22,12,17,12,5,2,1,1,1,1,0,14,8,6
0018,042737,Dankot,126,87,39,47,20,27,45,37,8,0,0,0,34,30,4
0018,042738,Arkhund,279,92,187,229,55,174,2,0,2,1,1,0,47,36,11
0018,042739,Rayari,281,165,116,164,54,110,0,0,0,0,0,0,117,111,6
0018,042740,Thapala,83,40,43,79,37,42,0,0,0,0,0,0,4,3,1
